                                                
                                               @@@@@@
                                                   @@
                                               @@  @@
                                             @@

  @@     @@@@   @@@@  @@@@  @@@@@@ @@  @@@@  @@@   @@
  @@    @@  @@ @@    @@  @@   @@   @@ @@  @@ @@@@  @@
  @@    @@  @@ @@    @@@@@@   @@   @@ @@  @@ @@ @@ @@
  @@    @@  @@ @@    @@  @@   @@   @@ @@  @@ @@  @@@@
  @@@@@  @@@@   @@@@ @@  @@   @@   @@  @@@@  @@   @@@