




  
  ██         ████  ██████ ██████ █████ ██████ ██████
 ██         ██  ██ ██     ██     ██      ██   ██    
██  ██████  ██████ ██████ ██████ █████   ██   ██████
 ██         ██  ██     ██     ██ ██      ██       ██
  ██        ██  ██ ██████ ██████ █████   ██   ██████