
  ██
 ██
██  ██████
 ██
  ██
        ██████   ██████   █████  ██      ███████
       ██       ██    ██ ██   ██ ██      ██     
       ██   ███ ██    ██ ███████ ██      ███████
       ██    ██ ██    ██ ██   ██ ██           ██
        ██████   ██████  ██   ██ ███████ ███████