
  @@@@@@
  @@
  @@  @@
        @@

        @@      @@@@@@@ @@    @@ @@@@@@@ @@      
        @@      @@      @@    @@ @@      @@      
        @@      @@@@@   @@    @@ @@@@@   @@      
        @@      @@       @@  @@  @@      @@      
        @@@@@@@ @@@@@@@   @@@@   @@@@@@@ @@@@@@@ 