
  ██████
  ██
  ██  ██
        ██

        ██      ███████ ██    ██ ███████ ██      
        ██      ██      ██    ██ ██      ██      
        ██      █████   ██    ██ █████   ██      
        ██      ██       ██  ██  ██      ██      
        ███████ ███████   ████   ███████ ███████ 