




  
  ██
 ██
██  ██████
 ██
  ██

    █████  ███████ ███████ ███████ ████████ ███████
   ██   ██ ██      ██      ██         ██    ██     
   ███████ ███████ ███████ █████      ██    ███████
   ██   ██      ██      ██ ██         ██         ██
   ██   ██ ███████ ███████ ███████    ██    ███████
          