     ██
   ██  ██
 ██      ██
     ██
     ██
     ██
     
  ████  ████      ██ ████  ███ ██████ ██ ██   ██ ████
 ██  ██ ██ ██     ██ ██   ██     ██   ██ ██   ██ ██  
 ██  ██ ████      ██ ████ ██     ██   ██ ██   ██ ████
 ██  ██ ██ ██ ██  ██ ██   ██     ██   ██  ██ ██  ██  
  ████  ████   ████  ████  ███   ██   ██   ███   ████