     .______.__________________._________________.
     |-Task-|----CONDITION-----|------ACTION-----| 
     |do    |                  |gotoMarket       |
     |      |                  |                 |
     |      |                  |                 |
     |      |                  |                 |
     |      |                  |                 |
     |      |                  |                 |
     |      |                  |                 |
     |      |                  |                 |
     |      |                  |                 |
     |      |                  |                 |
     |      |                  |                 |
     |      |                  |                 |
     |      |                  |                 |
     |______|__________________|_________________|
          